10,10,00,00,10,10,20,20,20
10,10,00,10,10,20,20,20,20
10,03,00,10,12,20,20,21,30
00,00,00,10,10,10,30,30,30
00,00,01,10,10,10,00,00,00
10,10,10,10,10,10,04,00,10
10,10,10,12,20,20,20,14,10
10,10,10,10,10,20,20,20,20
10,10,10,10,10,20,20,20,20
